# This file was automatically generated from the https://github.com/Belarus/GrammarDB
# data (Grammar Database of Belarusian language) using the RELEASE-202309 tag.
# Creative Commons Attribution-ShareAlike 4.0 International License.
#
# Uses UTF-8 format with U+0301 stress marks and U+2BC apostrophes. Each line lists
# a pair of alternative spelling variants of the same word delimited by '|'.
# Intended to be used by ebook dictionaries. If these two are not separate headwords
# in a dictionary, then it makes sense to link them together.
#
Ілья́|Ілля́
Індане́зія|Інданэ́зія
Іспа́нія|Гішпа́нія
Іярда́нія|Іарда́нія
Антве́рпен|Антвэ́рпэн
Анто́ніа|Анто́ніё
Аргенці́на|Аргенты́на
Аўгусці́н|Аўгусты́н
Бе́нджамін|Бе́нжамін
Бруне́й|Брунэ́й
Во́йцех|Во́йцэх
Гаспо́дзь|Го́спад
Герцагаві́на|Герцэгаві́на
Дзявя́тнік|Дзевя́тнік
Дзія́на|Дыя́на
Дняпро́|Дне́пр
Жамо́йція|Жамо́йтыя
Каля́ды|Ко́ляды
Ла́цыа|Ла́цыё
Лё́зна|Ліё́зна
Магаме́д|Магаме́т
Мо́рзэ|Мо́рзе
Мё́ры|Міё́ры
Мі́нск|Ме́нск
Навагру́дак|Нава́градак
Навапо́лацк|Навапо́лацак
Нейпʼідо́|Нейпідо́
Палесці́на|Палесты́на
По́лацк|По́лацак
Сі́львіа|Сі́львіё
То́кіа|То́кіо
Ху́ліа|Ху́ліё
Хэлаўі́н|Хэло́ўін
Шаўля́й|Шаўлі́
Шэ́рашава|Шарашэ́ва
Эфіо́пія|Эфіё́пія
Юпі́тэр|Юпі́цер
а́б|аба
а́д|ада
а́жыа|а́жыо
а́нгел|а́нгіл
а́нгел|анел
а́нгстрэм|ангстрэ́м
абʼе́зны|абʼязны́
абавязко́ва|абавя́зкава
абагу́льніць|абагульні́ць
аббудава́ны|аббудо́ваны
абгаблява́ны|абгаблё́ваны
абджы́гаць|абджыга́ць
абджы́нджарыць|абджынджа́рыць
абе́дзве|абе́дзві
абзе́тцар|абзе́тцэр
абка́м|абко́м
абка́маўскі|абко́маўскі
абкапа́ны|абко́паны
абкру́чаны|акру́чаны
абку́раны|аку́раны
абку́саны|абкуса́ны
аблама́ны|абло́маны
аблваенка́м|аблваенко́м
аблвыканка́м|аблвыканко́м
аблвыканка́маўскі|аблвыканко́маўскі
аблу́зганы|аблузга́ны
аблу́згаць|аблузга́ць
аблуза́ны|аблу́заны
аблы́ганы|аблыга́ны
аблямава́ны|аблямо́ваны
аблісце́ласць|аблі́сцеласць
аблісце́нне|аблі́сценне
абліцава́ны|абліцо́ваны
абману́ты|абма́нуты
абмата́ны|абмо́таны
абмежава́ны|абмяжо́ваны
абмеркава́ны|абмярко́ваны
абмурава́ны|абмуро́ваны
абмы́ты|амы́ты
абмяша́ны|абме́шаны
або́два|або́двы
абогатвара́цца|абагатвара́цца
абпілава́ны|абпіло́ваны
абрубны́|абру́бны
абсарбава́ны|абсарбі́раваны
абсві́станы|абсвіста́ны
абсмяя́ны|абсме́яны
абсорбцыяме́тр|абсо́рбцыяметр
абстраля́ны|абстрэ́ляны
абстру́ганы|абструга́ны
абсцэдзі́раваны|абсцэдзірава́ны
абсячы́|абсе́кчы
абсячы́|абсякчы́
абсячы́ся|абсе́кчыся
абтынкава́ны|абтынко́ваны
абфусцы́раваны|абфусцырава́ны
абця́жліва|абцяжлі́ва
абця́жлівы|абцяжлі́вы
абчапля́ны|абчэ́плены
абчаса́ны|абчэ́саны
абшалё́ваны|абшалява́ны
абшліфава́ны|абшліфо́ваны
абшмальцава́ны|абшмальцо́ваны
абшчы́паны|абшчыпа́ны
абы-я́к|абыя́к
абы́граны|абыгра́ны
абысці́|абыйсці́
абысці́ся|абыйсці́ся
аванпо́сны|аванпо́стны
агаблява́ны|агаблё́ваны
агаро́джа|агаро́жа
агра́фія|аграфі́я
аграма́дзіцца|аграмадзі́цца
аграма́дзіць|аграмадзі́ць
агу́чыць|агучы́ць
агітпра́п|агітпро́п
ада́жыа|ада́жыо
адамкнё́ны|адамкну́ты
адара́ны|адво́раны
адаткну́ты|адаткнё́ны
адбракава́ны|адбрако́ваны
адбудава́ны|адбудо́ваны
адваява́ны|адваё́ваны
адве́рнуты|адве́рнены
адгаблява́ны|адгаблё́ваны
адгадава́ны|адгадо́ваны
адгалінава́ны|адгаліно́ваны
адглянцава́ны|адглянцо́ваны
адграні́ць|адгра́ніць
аддзяўба́ны|аддзё́ўбаны
аддзяўба́ны|аддзё́ўбены
аддрукава́ны|аддруко́ваны
аджава́ны|аджо́ваны
адка́заны|адказа́ны
адкамандзірава́ны|адкамандзіро́ваны
адкапа́ны|адко́паны
адкаркава́ны|адкарко́ваны
адкарэкці́раваны|адкарэктава́ны
адкляпа́ны|адклё́паны
адко́ваны|адкава́ны
адко́ланы|адко́латы
адку́пшчык|адкупшчы́к
адлакірава́ны|адлакава́ны
адлама́ны|адло́маны
адлама́ны|адло́млены
адлупцава́ны|адлупцо́ваны
адлушчы́цца|адлу́шчыцца
адмабілізава́ны|адмабілізо́ваны
адмата́ны|адмо́таны
адмацава́ны|адмацо́ваны
адмежава́ны|адмяжо́ваны
адмо́латы|адме́лены
адмыка́ць|адмыка́ці
адна́к|адна́ка
адна́к|адна́ча
аднашпі́ндальны|аднашпі́ндэльны
аднікелірава́ны|аднікелява́ны
аднікелірава́ны|аднікеліро́ваны
адпа́свены|адпа́шчаны
адпампава́ны|адпампо́ваны
адпая́ны|адпа́яны
адплы́сці|адплы́ць
адпрасава́ны|адпрасо́ваны
адпужа́ны|адпу́жаны
адпіхну́ты|адпі́хнуты
адратава́ны|адрато́ваны
адрэкамендава́ны|адрэкамендо́ваны
адрэпеці́раваны|адрэпетава́ны
адстыкава́ны|адстыко́ваны
адсцяба́ны|адсцё́баны
адсячы́|адсе́кчы
адсячы́ся|адсе́кчыся
адтапта́ны|адто́птаны
адтулі́ць|адту́ліць
адтынкава́ны|адтынко́ваны
адтэрмінава́ны|адтэрміно́ваны
адукава́ны|адуко́ваны
адфрэзерава́ны|адфрэзеро́ваны
адфільтрава́ны|адфільтро́ваны
адхіну́ты|адхі́нены
адхіну́ты|адхі́нуты
адце́снены|адцяснё́ны
адчаса́ны|адчэ́саны
адчы́ркнуць|адчыркну́ць
адчы́таны|адчыта́ны
адшліфава́ны|адшліфо́ваны
адштампава́ны|адштампо́ваны
адштукава́ны|адштуко́ваны
адшчы́пнуты|адшчыпну́ты
ады́граны|адыгра́ны
адысці́|адыйсці́
адысці́ся|адыйсці́ся
адыхо́дная|адхо́дная
ажно́|а́жна
ажно́|анно́
азааспермі́я|азааспе́рмія
азбестабі́тумны|азбестабіту́мны
азелянё́ны|азяле́нены
азні́бець|азнібе́ць
азотаба́ктар|азотаба́ктэр
азотабактары́н|азотабактэры́н
айкані́мія|айканімі́я
акава́ны|ако́ваны
акальцава́ны|акальцо́ваны
акамадзі́равацца|акамадава́цца
акамадзі́раваць|акамадава́ць
акантава́ны|аканто́ваны
акапа́ны|ако́паны
акары́на|ака́рына
акваметры́я|акваме́трыя
акру́жаны|абкру́жаны
акрылі́цца|акры́ліцца
акрылі́ць|акры́ліць
акрэдытава́ны|акрэдыто́ваны
аксідава́ны|аксідзі́раваны
акта́эдр|актаэ́др
актывава́ны|актыві́раваны
аку́стаэлектронны|акустаэлектро́нны
акулі́раваны|акулірава́ны
акулі́раваны|акуліро́ваны
акулі́раваць|акулірава́ць
акулірава́нне|акулі́раванне
акулірава́цца|акулі́равацца
акумулява́нне|акумулі́раванне
акумулява́цца|акумулі́равацца
акумулява́ць|акумулі́раваць
акумулі́раваны|акумулява́ны
акупава́ны|акупі́раваны
акупава́цца|акупі́равацца
акцыянава́ць|акцыяні́раваць
акцэптава́ны|акцэпто́ваны
акіркава́ны|акірко́ваны
але́|а́ле
аленянё́|аленяня́
алкаліме́трыя|алкаліметры́я
алітара́цыя|алітэра́цыя
алітарацы́йны|алітэрацы́йны
амнісці́раваны|амністава́ны
амі́н|а́ман
амі́н|амі́нь
анатамава́цца|анатамі́равацца
анатамава́ць|анатамі́раваць
анатамі́раваны|анатамава́ны
ангажава́цца|ангажы́равацца
ангажава́ць|ангажы́раваць
ангажы́раваны|ангажава́ны
андэгра́ўнд|андэгра́унд
анексі́раваны|анексава́ны
анестэзава́цца|анестэзі́равацца
анестэзава́ць|анестэзі́раваць
анестэзу́ючы|анестэзі́руючы
анестэзі́раваны|анестэзава́ны
анла́йнавы|онла́йнавы
анты́к|а́нтык
антысіме́трыя|антысіметры́я
анчо́ус|анчо́ўс
апартаме́нт|апарта́мент
апаўдня́|апаўдні́
аплява́ны|аплё́ваны
апо́вед|апо́вяд
апра́нуты|апра́нены
апрасава́ны|апрасо́ваны
апрацава́ны|апрацо́ваны
апраўда́ны|апра́ўданы
апублікава́ны|апубліко́ваны
апі́саны|апіса́ны
апілава́ны|апіло́ваны
ара́тай|арата́й
аргалі́|арга́лі
аргентаме́трыя|аргентаметры́я
аржа́ніца|аржані́ца
арлянё́|арляня́
арнітафа́ўна|арнітафа́уна
арпе́джыа|арпе́джыо
артапе́дыя|артапеды́я
асацыява́цца|асацыі́равацца
асацыява́ць|асацыі́раваць
асві́станы|асвіста́ны
аслянё́|асляня́
аснасці́цца|асна́сціцца
аснасці́ць|асна́сціць
астаркава́тасць|аста́ркаватасць
астаркава́ты|аста́ркаваты
астру́ганы|аструга́ны
асфальтабі́тумны|асфальтабіту́мны
асфі́ксія|асфіксі́я
асячы́|асе́кчы
асячы́|асе́ч
асячы́ся|асе́кчыся
асіме́трыя|асіметры́я
атара́ксія|атараксі́я
атры́маны|атрыма́ны
атрыма́ны|атры́маны
афла́йнавы|офла́йнавы
афрыка́ндар|афрыка́ндэр
афіня́нка|афі́нянка
афіня́нін|афі́нянін
афіцэ́р|ахвіцэ́р
ахіле́саў|ахіле́савы
ацыдыме́трыя|ацыдыметры́я
ашча́джанне|ашчаджа́нне
ашчы́паны|ашчыпа́ны
аэрафотаграмме́трыя|аэрафотаграмметры́я
аўдыявізуа́льны|аўдыёвізуа́льны
аўдыякасе́та|аўдыёкасе́та
аўдыясістэ́ма|аўдыёсістэ́ма
аўтагрэ́йдар|аўтагрэ́йдэр
аўтагрэйдары́ст|аўтагрэйдэры́ст
аўтарадыягра́ма|аўтарадыёгра́ма
аўтарадыягра́фія|аўтарадыёгра́фія
аўтаркі́я|аўта́ркія
аўтасэ́рвіс|аўтасе́рвіс
аўтса́йдар|аўтса́йдэр
аўтса́йдарскі|аўтса́йдэрскі
аўтса́йдарства|аўтса́йдэрства
ба́рмен|барме́н
ба́рмен|бармэн
ба́рменка|барме́нка
ба́ртар|ба́ртэр
ба́ртарны|ба́ртэрны
ба́рэль|барэ́ль
ба́ўар|ба́ўэр
бабранё́|бабраня́
баваўнасе́яльны|бавоўнасе́йны
баваўнасе́яльны|бавоўнасе́яльны
баваўнатка́цкі|бавоўнатка́цкі
багу́ністы|багуні́сты
бала́нда|баланда́
бала́сны|бала́стны
бала́стар|бала́стэр
барсучанё́|барсучаня́
барсянё́|барсяня́
бару́кацца|барука́цца
барука́нне|бару́канне
барука́цца|бару́кацца
барэ́тар|барэ́тэр
бе́дэкераўскі|бедэ́кераўскі
бе́лфасцкі|белфа́сцкі
бе́рма|бі́рма
бе́таль|бе́тэль
бе́таль|бетэ́ль
белчанё́|белчаня́
берасцяны́|берасця́ны
беркуцянё́|беркуцяня́
бесемерава́нне|бесеме́раванне
бешме́т|бе́шмет
блакга́ўз|блакга́уз
блакга́ўзны|блакга́узны
бланшырава́нне|бланшы́раванне
бланшырава́ць|бланшы́раваць
бле́ндар|бле́ндэр
блокба́стар|блокба́стэр
блю́зненне|блюзне́нне
блі́зу|блізу́
блі́стар|блі́стэр
блі́цкрыг|бліцкры́г
блізнё́|блізня́
бліндзі́равацца|бліндзірава́цца
бліндзі́раваць|бліндзірава́ць
богабая́зна|багабо́язна
богабая́зны|багабо́язны
бра́ндар|бра́ндэр
бра́танне|брата́нне
брандма́ўар|брандма́ўэр
брандма́ўарны|брандма́ўэрны
браняка́тар|браняка́тэр
бранірава́цца|брані́равацца
брахма́н|бра́хман
браці́ха|бра́ціха
бру́дар|бру́дэр
бру́мер|бруме́р
брударга́ўз|брудэрга́ўз
брударша́фт|брудэрша́фт
бу́бал|буба́л
буйвалянё́|буйваляня́
буйнапанэ́льны|буйнапане́льны
бундэсве́р|бу́ндэсвер
бундэста́г|бу́ндэстаг
бурымэ́|бурыме́
буслянё́|бусляня́
бы́|б
быдлё́|быдля́
было́|бы́ў
было́|была́
было́|былі́
бяспі́сьменнасць|бяспісьме́ннасць
бі́тумны|біту́мны
біту́м|бі́тум
біту́мны|бі́тумны
біятэлеме́трыя|біятэлеметры́я
біятэхні́я|біятэ́хнія
ва́тар|ва́тэр
ва́тарны|ва́тэрны
ва́таршчык|ва́тэршчык
ва́таршчыца|ва́тэршчыца
ваверчанё́|ваверчаня́
вагавы́|ва́гавы
ваенка́м|ваенко́м
ваенка́маўскі|ваенко́маўскі
ваенка́р|ваенко́р
ваенма́р|ваенмо́р
ваенрэўка́м|ваенрэўко́м
важанё́|важаня́
важычанё́|важычаня́
валвыканка́м|валвыканко́м
ванадатаме́трыя|ванадатаметры́я
вара́кушка|вараку́шка
варанянё́|вараняня́
варсяны́|варся́ны
васьмідзяся́тнік|васьмідзеся́тнік
васьмідзяся́ты|васьмідзеся́ты
васямна́ццаты|васемна́ццаты
васямна́ццаць|васемна́ццаць
ватарклазе́т|ватэрклазе́т
ватарлі́нія|ватэрлі́нія
ватармашы́на|ватэрмашы́на
ватарпа́с|ватэрпа́с
ватарпа́сны|ватэрпа́сны
ватарпалі́ст|ватэрпалі́ст
ватарпалі́стка|ватэрпалі́стка
ватарпо́ла|ватэрпо́ла
ватарпо́льны|ватэрпо́льны
ваўчанё́|ваўчаня́
вентылі́равацца|вентылява́цца
вентылі́раваць|вентылява́ць
вені́раваць|венірава́ць
венірава́цца|вені́равацца
венірава́ць|вені́раваць
верабʼянё́|верабʼяня́
верблюдзянё́|верблюдзяня́
ветэрынары́я|ветэрына́рыя
вечавы́|ве́чавы
во́жыкавы|во́жыкаў
во́зера|азяро́
во́семдзясят|во́семдзесят
воданаліўны́|воданалі́ўны
ву́зенька|вузе́нька
ву́зіць|вузі́ць
ву́сцішнасць|вусці́шнасць
вугранё́|вуграня́
вужанё́|вужаня́
вурзну́ць|ву́рзнуць
вучка́м|вучко́м
вы́спрабаваны|выспрабава́ны
вы́траўшчык|вытра́ўшчык
вы́траўшчыца|вытра́ўшчыца
выварны́|вы́варны
выга́рына|вы́гарына
выга́рышча|вы́гарышча
выдранё́|выдраня́
выканка́м|выканко́м
выканка́мавец|выканко́мавец
выканка́маўскі|выканко́маўскі
выпа́ліна|вы́паліна
высокабарто́вы|высокабартавы́
выстаўка́м|выстаўко́м
вярблюдзянё́|вярблюдзяня́
ві́рысты|віры́сты
ві́ша|віша́
віндро́ўар|віндро́ўэр
вінчэ́стар|вінчэ́стэр
га́йда|айда́
га́йда|гайда́
га́нгстар|га́нгстэр
га́нгстарскі|га́нгстэрскі
гадзючанё́|гадзючаня́
гадзянё́|гадзяня́
газго́льдар|газго́льдэр
галоўка́м|галоўко́м
галу́біць|галубі́ць
галубянё́|галубяня́
галчанё́|галчаня́
гангстары́зм|гангстэры́зм
гарбаце́ць|гарба́цець
гарвыканка́м|гарвыканко́м
гарка́м|гарко́м
гарнаста́евы|гарнаста́еў
гарнірава́ць|гарні́раваць
гаршне́п|га́ршнеп
ге́ндар|ге́ндэр
ге́ндарны|ге́ндэрны
гекса́эдр|гексаэ́др
геле́ртар|геле́ртэр
геле́ртарства|геле́ртэрства
геліко́птар|геліко́птэр
гене́зіс|ге́незіс
генеры́раваць|генерава́ць
гепа́рдавы|гепа́рдаў
глушанё́|глушаня́
глыбо́ка|глы́бака
глінабі́тумны|глінабіту́мны
гра́давы|градавы́
грамадзі́цца|грама́дзіцца
грамадзі́ць|грама́дзіць
грачанё́|грачаня́
гро́сбух|гросбу́х
гру́ндар|гру́ндэр
гру́ндарства|гру́ндэрства
груганянё́|груганяня́
груганё́|груганя́
грудабру́шны|грудабрушны́
грунтавы́|грунто́вы
група́рг|групо́рг
групка́м|групко́м
гры́нпісаўскі|грынпі́саўскі
грэ́йдар|грэ́йдэр
грэ́йдарны|грэ́йдэрны
грэйдары́ст|грэйдэры́ст
грэйпфру́т|грэ́йпфрут
гу́нтар|гу́нтэр
губвыканка́м|губвыканко́м
губрэўка́м|губрэўко́м
губча́ты|гу́бчаты
гудрані́равацца|гудранава́цца
гудрані́раваць|гудранава́ць
гусянё́|гусяня́
гуча́ць|гучэ́ць
гідраметалургі́я|гідраметалу́ргія
гідрапрыво́д|гідрапры́вад
гіпсаме́трыя|гіпсаметры́я
да́рма|дарма́
дагні́сці|дагні́ць
дазі́раванне|дазірава́нне
дазіме́тр|дазі́метр
дакі́дацца|дакіда́цца
далечыня́|далячы́нь
дамка́м|дамко́м
дамка́маўскі|дамко́маўскі
дапрызы́ўны|дапрызыўны́
дарма́|да́рма
дацэнтравы́|дацэ́нтравы
дашчы́паны|дашчыпа́ны
двана́ццацера|дванаццацё́ра
двухсастаўны́|двухсаста́ўны
джэрсі́|джэ́рсі
дзеўчанё́|дзеўчаня́
дзя́тлаў|дзя́тлавы
дзявя́тка|дзевя́тка
дзявя́ты|дзевя́ты
дзявя́цера|дзевяцё́ра
дзяся́так|дзеся́так
дзяся́тка|дзеся́тка
дзяся́тнік|дзеся́тнік
дзяся́ты|дзеся́ты
дзяся́цера|дзеся́цера
дзяся́цера|дзесяцё́ра
дзяся́цкі|дзеся́цкі
дзятка́р|дзятко́р
дзятка́раўскі|дзятко́раўскі
дзятлянё́|дзятляня́
дзяўчы́на|дзе́ўчына
дзі́ўна|дзіўно́
дзіцянё́|дзіцяня́
дзіцё́|дзіця́
драздзянё́|драздзяня́
драко́наў|драко́навы
дры́фтар|дры́фтэр
дры́фтарны|дры́фтэрны
дрыгвя́ны|дрыгвяны́
дрыгвяны́|дрыгвя́ны
дрэ́гстар|дрэ́гстэр
дублі́равацца|дублява́цца
дублі́раваць|дублява́ць
думпка́р|ду́мпкар
ды́скант|дыска́нт
дые́з|дыэ́з
дые́та|дыэ́та
дые́тны|дыэ́тны
дые́тнік|дыэ́тнік
дые́тык|дыэ́тык
дыеталагі́чны|дыэталагі́чны
дыетатэрапеўты́чны|дыэтатэрапеўты́чны
дыеты́чны|дыэты́чны
дыетэ́тыка|дыэтэ́тыка
дыетэты́чны|дыэтэты́чны
дыскутава́ць|дыскуці́раваць
дыслацы́равацца|дыслакава́цца
дыслацы́раваць|дыслакава́ць
дыспансе́рны|дыспансэ́рны
дыспансерыза́цыя|дыспансэрыза́цыя
дысплэ́й|дыспле́й
дыферэнцы́равацца|дыферэнцава́цца
дыферэнцы́раваць|дыферэнцава́ць
дыўрэты́чны|дыурэты́чны
дэ́рвіш|дэрві́ш
дэбарка́дар|дэбарка́дэр
дэбарка́дар|дэбаркадэ́р
дэбарка́дарны|дэбарка́дэрны
дэградава́ць|дэградзі́раваць
дэзынва́зія|дэзінва́зія
дэзынсекцы́йны|дэзінсекцы́йны
дэзынфармава́цца|дэзінфармава́цца
дэзынфармава́ць|дэзінфармава́ць
дэзынфармацы́йны|дэзінфармацыйны
дэзынфекцы́йны|дэзінфекцы́йны
дэзынфікава́нне|дэзінфікава́нне
дэзынфікава́цца|дэзынфіцы́равацца
дэзынфікава́цца|дэзінфіцы́равацца
дэзынфікава́ць|дэзынфіцы́раваць
дэзынфікава́ць|дэзінфіцы́раваць
дэкарава́ць|дэкары́раваць
дэко́дар|дэко́дэр
дэмантава́цца|дэманці́равацца
дэмантава́ць|дэманці́раваць
дэмаскі́раванне|дэмаскірава́нне
дэмаскі́равацца|дэмаскірава́цца
дэмаскі́раваць|дэмаскірава́ць
дэпазіта́рны|дэпазі́тарны
дэта́ндар|дэта́ндэр
дэфілява́ць|дэфілі́раваць
дэінсталі́раваць|дэінсталява́ць
епітымʼя́|епіты́мʼя
есаву́л|есау́л
есаву́льскі|есау́льскі
ж|жа́
жа́варанкаў|жа́варанкавы
жа́ўранкавы|жа́ўранкаў
жабянё́|жабяня́
жаке́рыя|жакеры́я
жо́рсткафіксаваны|жорсткафіксава́ны
жураўлянё́|жураўляня́
жы́тны|жытны́
з|са́
зʼі́нець|зʼіне́ць
зʼіне́лы|зʼі́нелы
за́зуб|зазу́б
забранірава́ны|забраніро́ваны
забранірава́цца|забрані́равацца
завя́зка|за́вязка
зага́даны|загада́ны
зазы́ўны|зазыўны́
зайчанё́|зайчаня́
закадзі́равацца|закадава́цца
закадзі́раваць|закадава́ць
зану́дзіць|занудзі́ць
занудзі́цца|зану́дзіцца
запа́мятаны|запамята́ны
запальні́ца|запа́льніца
заплясне́ласць|запле́снеласць
запраграмава́ць|запраграмі́раваць
запратакалява́ць|запратакалі́раваць
запу́жанасць|запужа́насць
запужа́ны|запу́жаны
засла́бы|заслабы́
заста́ўны|застаўны́
засілі́цца|засі́ліцца
засілі́ць|засі́ліць
затры́маны|затрыма́ны
зача́ўраць|зачаўра́ць
зашму́ляць|зашмуля́ць
заю́рыцца|заюры́цца
заюры́ць|заю́рыць
заўка́м|заўко́м
заўка́мавец|заўко́мавец
заўка́маўскі|заўко́маўскі
збра́тацца|збрата́цца
збытавы́|збы́тавы
зверанё́|звераня́
зга́мтацца|згамта́цца
зга́мтаць|згамта́ць
зграма́дзіцца|зграмадзі́цца
зграма́дзіць|зграмадзі́ць
землеўпарадкава́льны|землеўпара́дкавальны
злучны́|злу́чны
злыга́ны|злы́ганы
змадэлява́ць|змадэлі́раваць
змеянё́|змеяня́
змы́ўны|змыўны́
зну́дзіць|знудзі́ць
знудзі́цца|зну́дзіцца
зрыгну́ты|зры́гнуты
зрэ́дчас|зрэ́дзьчас
зу́лу|зулу́
зубавы́|зу́бавы
зубранё́|зубраня́
зымшы́ць|зʼімшы́ць
зымшэ́лы|зʼімшэ́лы
зымшэ́ць|зʼімшэ́ць
зына́чванне|зʼіна́чванне
зына́чвацца|зʼіна́чвацца
зына́чваць|зʼіна́чваць
зына́чыцца|зʼіна́чыцца
зына́чыць|зʼіна́чыць
зысці́|зыйсці́
зысці́ся|зыйсці́ся
зязюлянё́|зязюляня́
зімо́й|зімо́ю
к|ка́
ка́заны|каза́ны
ка́лій|ка́ль
ка́мфара|камфара́
ка́ртар|ка́ртэр
ка́рцар|ка́рцэр
ка́рцарны|ка́рцэрны
ка́тар|ка́тэр
ка́тарны|ка́тэрны
ка́тарнік|ка́тэрнік
ка́тарскі|ката́рскі
каагулява́цца|каагулі́равацца
каагулява́ць|каагулі́раваць
каге́рар|каге́рэр
казлянё́|казляня́
казулянё́|казуляня́
калашына́|калашы́на
калео́птар|калео́птэр
каля́|ла́
каля́|ля́
калявушны́|каляву́шны
каментава́цца|каменці́равацца
каментава́ць|каменці́раваць
кампʼю́тар|кампʼю́тэр
кампʼю́тарны|кампʼю́тэрны
кампʼютарыза́цыя|кампʼютэрыза́цыя
кампо́сны|кампо́стны
камса́рг|камсо́рг
камса́ргаўскі|камсо́ргаўскі
канвертава́нне|канверці́раванне
кансамэ́|кансаме́
канстытуява́нне|канстытуі́раванне
канстытуява́цца|канстытуі́равацца
канстытуява́ць|канстытуі́раваць
кантра́снасць|кантра́стнасць
кантра́сны|кантра́стны
кантрастава́ць|кантрасці́раваць
канянё́|каняня́
капры́чыа|капры́чыо
капё́р|ка́пар
капі́раванне|капірава́нне
капі́раваны|капірава́ны
капірава́цца|капі́равацца
капірава́цца|капіява́цца
капірава́ць|капі́раваць
капірава́ць|капіява́ць
капіту́л|капі́тул
каро́тка|ко́ратка
карумпі́раваць|карумпава́ць
каршачанё́|каршачаня́
каршунянё́|каршуняня́
катэ́тар|катэ́тэр
катэтарыза́цыя|катэтэрыза́цыя
катэтарызава́ць|катэтэрызава́ць
кахе́ксія|кахексі́я
кацянё́|кацяня́
качанё́|качаня́
кашча́васць|кашчава́сць
каўза́льнасць|кауза́льнасць
каўза́льны|кауза́льны
каўцкія́нец|кауцкія́нец
каўцкія́нскі|кауцкія́нскі
каўцкія́нства|кауцкія́нства
квінтэсэ́нцыя|квінтэсе́нцыя
ке́мпінг|кэ́мпінг
ке́мпінгавы|кэ́мпінгавы
ке́нарка|кена́рка
ке́тгут|кетгу́т
клаўна́да|клауна́да
клаўна́дны|клауна́дны
кло́ўн|кло́ун
кло́ўнскі|кло́унскі
ко́жны|ко́жын
ко́шар|ко́шэр
кра́тар|кра́тэр
кра́тарны|кра́тэрны
крайвыканка́м|крайвыканко́м
крайка́м|крайко́м
крацянё́|крацяня́
крумкачанё́|крумкачаня́
кры́ху|крыху́
крывяны́|крывя́ны
крыке́т|кры́кет
крытэ́рый|крытэ́р
крэ́йцар|крэ́йцэр
крэ́чатаў|крэ́чатавы
ксеракапі́раванне|ксеракапірава́нне
ксеракапі́раваны|ксеракапірава́ны
ксеракапі́равацца|ксеракапірава́цца
ксеракапі́раваць|ксеракапірава́ць
кузаўны́|ку́заўны
кумпя́чына|кумпячы́на
куранё́|кураня́
куявя́к|куя́вяк
кі́дальны|кіда́льны
кі́дацца|кіда́цца
кі́даць|кіда́ць
кі́навар|кінава́р
кіда́льны|кі́дальны
кіда́льнік|кі́дальнік
кіда́льніца|кі́дальніца
кіда́нне|кі́данне
кільва́тар|кільва́тэр
кільва́тарны|кільва́тэрны
ла́а|ла́о
лагарыфмава́ць|лагарыфмі́раваць
лака́ўт|лака́ут
лака́ўтчык|лака́утчык
лакаўтава́ць|лакаутава́ць
ламінава́ць|ламіні́раваць
ланка́старскі|ланка́стэрскі
ланцу́жны|ланцужны́
ласка́ва|ла́скава
ласянё́|ласяня́
лаці́нянка|лаціня́нка
лаці́нянін|лаціня́нін
лашачанё́|лашачаня́
ле́кавацца|лекава́цца
ле́каваць|лекава́ць
лебедзянё́|лебедзяня́
легі́раванне|легірава́нне
лекпа́м|лекпо́м
лесаўпара́дкавальны|лесаўпарадкава́льны
лу́зганы|лузга́ны
лу́згаць|лузга́ць
лугавы́|лу́гавы
лы́ндаваць|лындава́ць
львянё́|львяня́
льё́|лье́
лі́дар|лі́дэр
лі́дарскі|лі́дэрскі
лі́дарства|лі́дэрства
лі́стар|лі́стэр
лі́тавацца|літава́цца
лі́тасціва|літасці́ва
лі́тасцівасць|літасці́васць
лі́тасцівенькі|літасці́венькі
лі́тасцівы|літасці́вы
лі́фтавы|ліфтавы́
лі́хтар|лі́хтэр
лі́хтарны|лі́хтэрны
лінка́р|лінко́р
лістарава́ць|лістэрава́ць
лісянё́|лісяня́
літава́ны|лі́таваны
ліхтараво́з|ліхтэраво́з
ліхтараво́зны|ліхтэраво́зны
ма́кавішча|макаві́шча
ма́ркетынгавы|марке́тынгавы
магі́старскі|магі́стэрскі
магі́старства|магі́стэрства
мадэлява́цца|мадэлі́равацца
мадэлява́ць|мадэлі́раваць
мажны́|ма́жны
мака́а|мака́о
малапажы́ўны|малапажыўны́
маларазвіты́|маларазві́ты
малпянё́|малпяня́
малпі́ны|ма́лпіны
маманцянё|маманцяня
манчэ́стар|манчэ́стэр
маржанё́|маржаня́
марке́тынг|ма́ркетынг
маркшэ́йдар|маркшэ́йдэр
маркшэ́йдарскі|маркшэ́йдэрскі
маркшэ́йдарства|маркшэ́йдэрства
маркшэйдары́я|маркшэ́йдарыя
маркшэйдары́я|маркшэ́йдэрыя
маркшэйдары́я|маркшэйдэры́я
машынапі́сны|машы́напісны
ме́мфіскі|мемфі́скі
ме́неджар|ме́неджэр
ме́нзула|мензу́ла
ме́нзульны|мензу́льны
ме́хавы|мехавы́
медзведзянё́|медзведзяня́
межавы́|ме́жавы
менеджары́зм|менеджэры́зм
метаме́рыя|метамеры́я
младапі́сьменны|младапісьме́нны
млынавы́|млы́навы
мнагашпі́ндальны|мнагашпі́ндэльны
многасаста́ўны|многасастаўны́
мо́нстр|мо́нстар
му́скулістасць|мускулі́стасць
му́скулісты|мускулі́сты
мусцье́рскі|мустʼе́рскі
мыля́ць|мы́ляць
мышанё́|мышаня́
мэ́рылендскі|мэрыле́ндскі
мясцка́м|мясцко́м
мясцка́мавец|мясцко́мавец
мясцка́маўскі|мясцко́маўскі
мі́стар|мі́стэр
мі́таль|мі́тэль
мі́тальшпіль|мі́тэльшпіль
міжзу́бны|міжзубны́
мікрафа́ўна|мікрафа́уна
міэлацы́т|міелацы́т
міэлі́н|міелі́н
міэлі́навы|міелі́навы
міэлі́т|міелі́т
на́вісь|наві́сь
на́д|нада
на́нду|нанду́
на́нсук|нансу́к
на́нсукавы|нансу́кавы
на́скі|на́ські
нававы́браны|новавы́браны
нававы́дадзены|новавы́дадзены
нававы́найдзены|новавы́найдзены
награма́дзіць|награмадзі́ць
надстру́ганы|надструга́ны
нады́мляць|надымля́ць
надындывідуа́льны|надіндывідуа́льны
надысці́|надыйсці́
найпе́рш|найпярве́й
найсклада́нейшы|найсклада́ны
найслабе́йшы|найсла́бшы
найслабе́йшы|найслабы
найсмачне́йшы|найсмачны
найспрытне́йшы|найспрытны
найстаражы́тнейшы|найстаражытны
найстрашне́йшы|найстрашны
найтанне́йшы|найтанны
найцудо́ўнейшы|найцудо́ўны
накапі́раваць|накапірава́ць
наксеракапі́раваны|наксеракапірава́ны
наксеракапі́раваць|наксеракапірава́ць
накто́ўз|накто́уз
накуро́дымець|накуро́дыміць
нала́даваны|наладава́ны
наладава́ць|нала́даваць
налу́заны|налуза́ны
налу́зганы|налузга́ны
налу́згаць|налузга́ць
нанпарэ́ль|нонпарэ́ль
нану́дзіцца|нанудзі́цца
наплыўны́|наплы́ўны
нарка́м|нарко́м
нарка́маўскі|нарко́маўскі
насадны́|наса́дны
насві́станы|насвіста́ны
насу́праціў|насупраці́ў
нафтабі́тумны|нафтабіту́мны
начадзі́ць|нача́дзіць
начы́таны|начыта́ны
нашвы́рганы|нашвырга́ны
нашчы́паны|нашчыпа́ны
наўкру́га|наўкруга́
не́прыяцелька|непрыя́целька
неабстру́ганы|неабструга́ны
неабы́граны|неабыгра́ны
неабыя́кі|неабыякі́
неапра́ўданы|неапраўда́ны
неатрыма́ны|неатры́маны
небіткі́|небі́ткі
невыкупны́|невыку́пны
негрыцянё́|негрыцяня́
недаразві́ты|недара́звіты
недатры́маны|недатрыма́ны
недатрыма́ны|недатры́маны
недачы́таны|недачыта́ны
нейракампʼю́тар|нейракампʼю́тэр
непрачыта́ны|непрачы́таны
неразга́данасць|неразгада́насць
нерпянё́|нерпяня́
несало́дка|нясо́ладка
нефраліты́яз|нефралітыя́з
нечленараздзе́льнасць|нячленараздзе́льнасць
неўпарадкава́насць|неўпара́дкаванасць
неўрадлі́вы|неўра́длівы
но́нсэнс|но́нсенс
но́ўтбук|ноўтбу́к
нудзі́ць|ну́дзіць
ню́рнбергскі|нюрнбе́ргскі
нябо́ж|нябо́жа
няйна́кш|найна́кш
нялі́тасцівы|нелітасці́вы
нячленараздзе́льны|нечленараздзе́льны
ні́зенечкі|нізе́нечкі
ні́зкадаходны|нізкадахо́дны
нібы́|ні́бы
нібы́та|ні́быта
ніжэйзгада́ны|ніжэйзга́даны
нізкапрадукты́ўны|нізкапрадукцы́йны
нітавы́|ні́тавы
ніякава́тасць|нія́каватасць
ніякава́ты|нія́каваты
о́рдар|о́рдэр
о́рдарны|о́рдэрны
па́д|пада
па́мятацца|памята́цца
па́мятаць|памята́ць
па́стыр|пасты́р
па́тарскі|па́тэрскі
па́часкавы|пача́скавы
пабару́кацца|пабарука́цца
паблакі́тнець|паблакітне́ць
пабо́лей|пабо́льш
пабурча́ць|пабурчэ́ць
павятка́м|павятко́м
пагнюсі́цца|пагню́сіцца
пагнюсі́ць|пагню́сіць
пагні́сці|пагні́ць
падʼесаву́л|падʼесау́л
пада́лей|падале́й
падбры́кнуць|падбрыкну́ць
падва́хтавы|падвахтавы́
падгні́лы|падгнілы́
падкліка́ны|падклі́каны
падпара́дкавальны|падпарадкава́льны
падпара́дкаванасць|падпарадкава́насць
падпарадкава́нне|падпара́дкаванне
падса́дны|падсадны́
падсыці́ць|падсы́ціць
падтры́маны|падтрыма́ны
падтрыма́ны|падтры́маны
падчы́таны|падчыта́ны
падыскутава́ць|падыскуці́раваць
падысці́|падыйсці́
пажа́длівы|пажадлі́вы
пажадлі́васць|пажа́длівасць
пазвяга́ць|пазвя́гаць
пазіцыянава́ць|пазіцыяні́раваць
пакга́ўз|пакга́уз
пакга́ўзны|пакга́узны
пакуса́ны|паку́саны
пале́каваць|палекава́ць
палу́заны|палуза́ны
палу́шчыць|палушчы́ць
палігра́фія|паліграфі́я
памы́ляць|памыля́ць
памята́цца|па́мятацца
панге́незіс|пангене́зіс
пану́дзіць|панудзі́ць
панудзі́цца|пану́дзіцца
панчая́т|панча́ят
панэ́ль|пане́ль
панэ́льны|пане́льны
панэляво́з|панеляво́з
пані́ч|па́ніч
папа́мятаць|папамята́ць
папа́я|папа́йя
папазвя́гаць|папазвяга́ць
папра́духа|папраду́ха
пара́люш|паралю́ш
пара́ліч|паралі́ч
парано́йя|парано́я
парафразава́ць|парафразі́раваць
парахма́нець|парахмане́ць
парта́рг|парто́рг
партка́м|партко́м
парухаве́ць|паруха́вець
пасля́|апасля́
пасля́|пасле́й
пасрэ́днік|пасярэ́днік
пастаршы́нстваваць|пастаршынствава́ць
пастра́шыць|пастрашы́ць
пасціжо́р|пастыжо́р
пата́нненне|патанне́нне
патайны́|пата́йны
пацучанё́|пацучаня́
пачасці́цца|пача́сціцца
паша́рпаны|пашарпа́ны
пашарпа́цца|паша́рпацца
пашарпа́ць|паша́рпаць
паэкзэмпля́рны|паэкземпля́рны
паўдзяся́тка|паўдзеся́тка
паўтры́зненне|паўтрызне́нне
пе́йджар|пе́йджэр
пе́рад|пе́рада
пе́рад|перада
пе́рад|пра́д
пе́рад|прада
пе́рлінь|перлі́нь
пеліка́навы|пеліка́наў
перааснасці́ць|пераасна́сціць
перадынфа́рктны|перадінфа́рктны
перакапі́раваны|перакапірава́ны
перакапі́раваць|перакапірава́ць
перакапірава́ць|перакапі́раваць
перале́кавацца|пералекава́цца
пералыга́ны|пералы́ганы
перану́дзіцца|перанудзі́цца
перану́дзіць|перанудзі́ць
перапелянё́|перапеляня́
перапраграмава́цца|перапраграмі́равацца
перапраграмава́ць|перапраграмі́раваць
перапрафілява́ць|перапрафілі́раваць
пераспялі́ць|пераспе́ліць
перасука́ны|перасу́каны
ператрыма́ны|ператры́маны
перачы́таны|перачыта́ны
перая́слаўскі|пераясла́ўскі
перфарава́ць|перфары́раваць
планшы́р|пла́ншыр
пло́тар|пло́тэр
плу́нжар|плу́нжэр
плу́нжарны|плу́нжэрны
плэйбо́й|плейбо́й
по́йнтар|по́йнтэр
по́льдар|по́льдэр
по́льдарны|по́льдэрны
по́ртар|по́ртэр
по́ртарны|по́ртэрны
по́стар|по́стэр
по́тнік|патні́к
поліўрэта́навы|поліурэта́навы
пра́вільнейшы|правільне́йшы
пра́зем|празе́м
праблісну́ць|праблі́снуць
прагназава́нне|прагназі́раванне
прагназава́ць|прагназі́раваць
праграмава́нне|праграмі́раванне
праграмава́цца|праграмі́равацца
праграмава́ць|праграмі́раваць
прадзюсава́ць|прадзюсі́раваць
прадублява́ць|прадублі́раваць
прадыферэнцава́ць|прадыферэнцыраваць
прадэзынфікава́ць|прадэзынфіцы́раваць
прадэзынфікава́ць|прадэзінфікава́ць
прадэзынфікава́ць|прадэзінфіцы́раваць
праецы́равацца|праецыявацца
праецы́раваць|праецыяваць
пракаментава́ць|пракаменці́раваць
пралабі́равацца|пралабіявацца
пралабі́раваць|пралабіяваць
прамыславі́к|прамысло́вік
пранудзі́цца|прану́дзіцца
пранудзі́ць|прану́дзіць
праніза́ны|прані́заны
прапальпаваць|прапальпіраваць
прасталю́дзін|прасталюдзі́н
пратапрэсві́тар|пратапрэсві́тэр
пратэлефанава́ць|пратэлефані́раваць
прафа́рг|прафо́рг
прафа́ргаўскі|прафо́ргаўскі
прафгрупа́рг|прафгрупо́рг
прафка́м|прафко́м
прафка́маўскі|прафко́маўскі
прачы́таны|прачыта́ны
прачыта́ны|прачы́таны
прашту́рхацца|праштурха́цца
праштурха́ць|прашту́рхаць
протапрэсві́тар|протапрэсві́тэр
пру́тка|пру́дка
пру́тка|пры́тка
пры́думка|прыду́мка
пры́мхлівы|прымхлі́вы
пры́нтар|пры́нтэр
пры́нтарны|пры́нтэрны
пры́яцель|прыя́цель
пры́яцелька|прыя́целька
пры́яцельскі|прыя́цельскі
пры́яцельства|прыя́цельства
прыду́ркавата|прыдуркава́та
прыду́ркаваты|прыдуркава́ты
прыку́с|пры́кус
прымхлі́васць|пры́мхлівасць
прыну́дзіцца|прынудзі́цца
прытры́маны|прытрыма́ны
прышпільны́|прышпі́льны
прышчаве́ць|прышча́вець
прышчы́кнуты|прышчыкну́ты
прышчыпну́ты|прышчы́пнуты
прыя́цельскі|пры́яцельскі
прэмірава́цца|прэміява́цца
прэмірава́ць|прэміява́ць
прэпарава́ць|прэпары́раваць
прэсві́тар|прэсві́тэр
прэсвітарыя́нец|прэсвітэрыя́нец
прэсвітарыя́нка|прэсвітэрыя́нка
прэсвітарыя́нскі|прэсвітэрыя́нскі
прэсвітарыя́нства|прэсвітэрыя́нства
прэсвітарыя́нін|прэсвітэрыя́нін
псіхагене́зіс|псіхаге́незіс
птушанё́|птушаня́
птушы́нка|пту́шынка
пу́льтавая|пультава́я
пу́шчанскі|пушча́нскі
пэ́йджар|пэ́йджэр
пэцкані́на|пэ́цканіна
пя́дзенік|пядзе́нік
пяцьдзяся́т|пяцьдзеся́т
пяцідзяся́тнік|пяцідзеся́тнік
пяцідзяся́тніца|пяцідзеся́тніца
пяцідзяся́ты|пяцідзеся́ты
пі́нчар|пі́нчэр
пінгвінянё́|пінгвіняня́
пінцы́раванне|пінцырава́нне
піраме́трыя|піраметры́я
пісклянё́|піскляня́
пісьме́нны|пі́сьменны
піяла́|пія́ла
ра́джа|раджа́
ра́йдар|ра́йдэр
ра́ўнд|ра́унд
ра́ўт|ра́ут
рабачка́м|рабачко́м
рабачка́маўскі|рабачко́маўскі
рабка́р|рабко́р
рабка́раўскі|рабко́раўскі
рабселька́р|рабселько́р
рабселька́раўскі|рабселько́раўскі
радыёме́тр|радыё́метр
радыёўніверсітэ́т|радыёуніверсітэ́т
радэ́а|радэ́о
разʼю́рыцца|разʼюры́цца
разблакірава́ць|разблакі́раваць
разбіўны́|разбі́ўны
раздражнё́на|раздра́жнена
разлуза́ны|разлу́заны
разлыга́ны|разлы́ганы
размы́ўны|размыўны́
разна́сцежыць|разнасце́жыць
разысці́ся|разыйсці́ся
райвыканка́м|райвыканко́м
райвыканка́маўскі|райвыканко́маўскі
райгра́с|ра́йграс
райка́м|райко́м
райка́мавец|райко́мавец
райка́маўскі|райко́маўскі
рамантава́цца|рэманці́равацца
рамантава́ць|рэмантава́ць
рамантава́ць|рэманці́раваць
раскача́ны|раска́чаны
раскашава́цца|раскаша́цца
распра́нуты|распрану́ты
распу́кнуты|распукну́ты
распукну́цца|распу́кнуцца
распукну́ць|распу́кнуць
распыта́ны|распы́таны
расхля́бацца|расхляба́цца
ратані́я|рата́нія
рачанё́|рачаня́
ржаві́нне|ржа́вінне
ру́дзенькі|рудзе́нькі
румяне́ць|румя́нець
ры́дар|ры́дэр
ры́марства|рыма́рства
рысянё́|рысяня́
рэ́йдар|рэ́йдэр
рэ́йдарскі|рэ́йдэрскі
рэ́феры|рэферы́
рэзюмава́ць|рэзюмі́раваць
рэйсфе́дар|рэйсфе́дэр
рэйсфе́дарны|рэйсфе́дэрны
рэкру́цкі|рэ́круцкі
рэпі́тар|рэпі́тэр
рэінвестава́ць|рэінвесці́раваць
рэўка́м|рэўко́м
рэўка́мавец|рэўко́мавец
рэўка́маўскі|рэўко́маўскі
са́ўна|са́уна
сабалянё́|сабаляня́
сабачанё́|сабачаня́
саветыза́цыя|савеціза́цыя
саветызава́цца|савецізі́равацца
саветызава́ць|савецізі́раваць
савянё́|савяня́
садавіна́|садаві́на
сакалянё́|сакаляня́
саке́|сакэ́
салаўянё́|салаўяня́
сале́транка|салетра́нка
сало́дка|со́ладка
сальфе́джыа|сальфе́джыо
саляны́|саля́ны
самапраграмава́нне|самапраграмі́раванне
самянё́|самяня́
санкцыянава́нне|санкцыяні́раванне
санкцыянава́цца|санкцыяні́равацца
санкцыянава́ць|санкцыяні́раваць
сарганізава́цца|зарганізава́цца
сарганізава́ць|зʼарганізава́ць
сарганізава́ць|зарганізава́ць
сарфава́ць|зарфава́ць
сарыгіна́льнічаць|зʼарыгіна́льнічаць
сарыгіна́льнічаць|зарыгіна́льнічаць
сарыентава́цца|зʼарыентава́цца
сарыентава́цца|зарыентава́цца
сарыентава́ць|зʼарыентава́ць
сарыентава́ць|зарыентава́ць
саіска́льнік|суіска́льнік
саіска́льніца|суіска́льніца
саіска́льніцтва|суіска́льніцтва
саіска́нне|суіска́нне
саўнарка́маўскі|саўнарко́маўскі
сві́тар|сві́тэр
се́льтарскі|се́льтэрскі
се́псіс|сэ́псіс
се́тар|се́тэр
сельвыканка́м|сельвыканко́м
селька́р|селько́р
селька́раўскі|селько́раўскі
селька́рка|селько́рка
селька́рства|селько́рства
сервіту́тны|сэрвіту́тны
скапі́раваць|скапірава́ць
скапіява́ць|скапі́раваць
сква́тар|сква́тэр
склераметры́я|склераме́трыя
ску́лаваты|скулава́ты
ску́тар|ску́тэр
ску́тарны|ску́тэрны
скулава́ты|ску́лаваты
скутары́ст|скутэры́ст
скутары́стка|скутэры́стка
сла́бенькі|слабе́нькі
сла́бы|слабы́
сла́ўны|сла́вен
слабе́нькі|сла́бенькі
слабкі́|сла́бкі
сланянё́|сланяня́
смы́канне|смыка́нне
снасці́ць|сна́сціць
спаге́ці|спаге́цці
спаніэ́ль|спаніе́ль
спартклу́б|спортклу́б
спартко́мплекс|спортко́мплекс
спелеафа́ўна|спелеафа́уна
спецка́р|спецко́р
спецка́раўскі|спецко́раўскі
спрагназава́ць|спрагназі́раваць
спры́нтар|спры́нтэр
спры́нтарскі|спры́нтэрскі
спі́рытус|спіры́тус
ста́ртар|ста́ртэр
ста́ртарны|ста́ртэрны
старпа́м|старпо́м
старпа́маўскі|старпо́маўскі
старчма́|старчако́м
старчма́|старчко́м
старчма́|старчмака́
старчма́|сто́рчам
стату́т|ста́тут
стату́тны|ста́тутны
страусянё́|страусяня́
страшы́цца|стра́шыцца
стрыжанё́|стрыжаня́
сты́кавы|стыкавы́
стэ́ндар|стэ́ндэр
стэ́ндарны|стэ́ндэрны
стэрэаізамеры́я|стэрэаізаме́рыя
су́днавы|суднавы́
су́мавы|сумавы́
суа́ўтар|саа́ўтар
суа́ўтарскі|саа́ўтарскі
суа́ўтарства|саа́ўтарства
суаранда́тар|сааранда́тар
суарэ́нда|саарэ́нда
субстантывава́ны|субстантыві́раваны
субстантывава́цца|субстантыві́равацца
субынспе́ктар|субінспе́ктар
суву́чань|саву́чань
сувучані́ца|савучані́ца
сувінава́ты|савінава́ты
сугаспада́р|сагаспада́р
судакла́д|садакла́д
судакла́дчык|садакла́дчык
судо́ва-медыцы́нскі|судовамедыцы́нскі
сукрэдыто́р|сакрэдыто́р
супадпара́дкаванне|супадпарадкава́нне
супадпара́дкаваны|супадпарадкава́ны
супадпара́дкаваць|супадпарадкава́ць
суперме́н|супермэ́н
суперме́нскі|супермэ́нскі
супляме́ннік|сапляме́ннік
сурэда́ктар|сарэда́ктар
сурэжысё́р|сарэжысё́р
суслянё́|сусляня́
сутво́рчасць|сатво́рчасць
суту́лаватасць|сутулава́тасць
суту́лаваты|сутулава́ты
суісце́ц|саісце́ц
сфармулява́ць|сфармулі́раваць
сфі́нктар|сфі́нктэр
схлусі́ць|схлу́сіць
сцю́ард|сцюа́рд
счыта́ны|счы́таны
сы́рамятны|сырамя́тны
сы́рамяць|сырамя́ць
сыгра́ны|сы́граны
сысці́|сыйсці́
сысці́ся|сыйсці́ся
сыці́ць|сы́ціць
сычанё́|сычаня́
сэ́нсар|се́нсар
сэ́нсарны|се́нсарны
сэ́рвіс|се́рвіс
сэ́тар|сэ́тэр
сэкано́міць|зʼэкано́міць
сэкано́міць|зэкано́міць
сэнсо́рны|сенсо́рны
сюдо́й|сюдо́ю
сюдо́й|сюдэ́й
сюдо́й|сюдэ́ю
сямна́ццаты|семна́ццаты
сямна́ццаць|семна́ццаць
сямідзяся́тнік|сямідзеся́тнік
сямідзяся́ты|сямідзеся́ты
сярэднеразвіты́|сярэднеразві́ты
сі́ненькі|сіне́нькі
сівучанё́|сівучаня́
сівы́|сі́вы
сінанімі́я|сінані́мія
та́ндэмны|тандэ́мны
талрэ́п|та́лрэп
танкаствало́вы|тонкаствало́вы
тапіна́мбур|тапінамбу́р
тарпедакіда́нне|тарпедакі́данне
то́й|тэ́й
то́стар|то́стэр
тра́пезны|трапе́зны
трансмі́тар|трансмі́тэр
трапе́за|тра́пеза
трапе́зны|тра́пезны
трохвале́нтны|трохва́лентны
трусянё́|трусяня́
трухля́вець|трухляве́ць
тры́а|тры́о
тры́зненне|трызне́нне
трыдзявя́ты|трыдзевя́ты
трыдзяся́ты|трыдзеся́ты
трыумфава́ць|трыўмфаваць
трэ́йдар|трэ́йдэр
трэ́кавік|трэкаві́к
трэшко́ўт|трэшко́ут
ту́былец|тубы́лец
ту́былка|тубы́лка
ту́быльскі|тубы́льскі
тунэ́ль|туне́ль
тунэ́льны|туне́льны
тунэ́льшчык|туне́льшчык
тунэлебудава́нне|тунелебудава́нне
туранё́|тураня́
тхаранё́|тхараня́
тыгранё́|тыграня́
тынэ́йджар|тынэ́йджэр
тыры́стар|тыры́стэр
тыры́старны|тыры́стэрны
тэ́зісны|тэзі́сны
тэ́ндар|тэ́ндэр
тэ́ндарны|тэ́ндэрны
тэ́танус|тэта́нус
тэбенява́ць|тэбенева́ць
тэлекінеты́чны|тэлекіне́тычны
тэлефанава́нне|тэлефані́раванне
тэлефанава́ць|тэлефані́раваць
тэрмі́я|тэ́рмія
тэсці́раваць|тэстава́ць
у|ва́
у|ува
увяза́ны|увя́заны
уві́шны|увішны́
углы́бкі|углыбкі́
уда́ленькі|удале́нькі
узʼю́рыцца|узʼюры́цца
узгадні́ць|узго́дніць
уласка́віць|ула́скавіць
уна́трус|унатру́с
уна́труску|унатру́ску
уну́рыцца|унуры́цца
уну́рыць|унуры́ць
уселітасці́вы|уселі́тасцівы
уча́дзіцца|учадзі́цца
уча́дзіць|учадзі́ць
ушы́ркі|ушыркі́
фа́ўна|фа́уна
фабзаўка́м|фабзаўко́м
фабзаўка́мавец|фабзаўко́мавец
фабзаўка́маўскі|фабзаўко́маўскі
фабка́м|фабко́м
фабка́маўскі|фабко́маўскі
факсі́мільны|факсімі́льны
факусі́раванне|факусірава́нне
факусі́равацца|факусавацца
факусі́раваць|факусава́ць
фара́да|фарада́
фарва́тар|фарва́тэр
фарва́тарны|фарва́тэрны
фарматава́ць|фармаці́раваць
фаўні́ст|фауні́ст
фаўні́стыка|фауні́стыка
фаўністы́чны|фауністы́чны
фаўстпатро́н|фаустпатро́н
фла́тар|фла́тэр
флама́стар|флама́стэр
флама́старскі|флама́стэрскі
флебатонаме́трыя|флебатонаметры́я
фо́ліа|фо́ліо
фо́рталь|фо́ртэль
фотакантра́сны|фотакантра́стны
франкава́цца|франкі́равацца
франкава́ць|франкі́раваць
фрыра́йдар|фрыра́йдэр
фрытрэ́дар|фрытрэ́дэр
фрытрэ́дарскі|фрытрэ́дэрскі
фрытрэ́дарства|фрытрэ́дэрства
функцыянава́нне|функцыяні́раванне
функцыянава́ць|функцыяні́раваць
фурма́н|фу́рман
фю́рар|фю́рэр
фі́дар|фі́дэр
фі́дарны|фі́дэрны
фі́дарны|фідэ́рны
фі́нішар|фі́нішэр
фі́тнес|фі́тнэс
фіза́рг|фізо́рг
філі́стар|філі́стэр
філі́старскі|філі́стэрскі
філі́старства|філі́стэрства
філісты́млянскі|філістымля́нскі
фіні́метр|фініме́тр
хлапчанё́|хлапчаня́
хле́бна|хлябно́
хло́пец|хлапе́ц
хмылі́цца|хмы́ліцца
хо́ладна|хало́дна
хра́мавы|храмавы́
цецеруко́вы|цецеруко́ў
цугавы́|цу́гавы
цугу́ндар|цугу́ндэр
цы́цар|цы́цэр
цы́цара|цы́цэра
цыганё́|цыганя́
цэйхга́ўз|цэйхга́уз
цэйхга́ўзны|цэйхга́узны
цэхка́м|цэхко́м
цюленянё́|цюленяня́
цялё́|цяля́
цячы́|це́кчы
цячы́|цякчы́
ці́хенечка|ціхе́нечка
ці́хенечкі|ціхе́нечкі
ці́хенька|ціхе́нька
ці́хенькі|ціхе́нькі
ча́ртар|ча́ртэр
ча́ртарны|ча́ртэрны
ча́ўш|ча́уш
чадзі́ць|ча́дзіць
чалю́скінец|чэлю́скінец
чанавы́|ча́навы
чарапашанё́|чарапашаня́
чарке́с|чэрке́с
чарке́ска|чэрке́ска
чарке́шанка|чэрке́шанка
чарцянё́|чарцяня́
чатырохва́лентны|чатырохвале́нтны
чачэ́нец|чэчэ́нец
чачэ́нка|чэчэ́нка
чачэ́нскі|чэчэ́нскі
членка́р|членко́р
чоўнападо́бны|чо́ўнападобны
чу́дскі|чудскі́
чу́мны|чумны́
чу́тна|чутно́
чужа́нін|чужані́н
чы́сцец|чысце́ц
чы́таны|чыта́ны
чыранё́|чыраня́
чэ́стар|чэ́стэр
ша́рпаць|шарпа́ць
шаба́савы|ша́басавы
шакі́равацца|шакавацца
шакі́раваць|шакава́ць
шасцідзяся́тнік|шасцідзеся́тнік
шасцідзяся́тніца|шасцідзеся́тніца
шасцідзяся́ты|шасцідзеся́ты
шкада́|шко́да
шканды́баць|шкандыба́ць
шке́нцаль|шке́нцель
шклографава́цца|шклографі́равацца
шклографава́ць|шклографі́раваць
шля́хціц|шля́хціч
шліхавы́|шлі́хавы
шматʼя́русны|шматя́русны
шматсастаўны́|шматсаста́ўны
шмыгну́ць|шмы́гнуць
шні́цаль|шні́цэль
шпа́таль|шпа́тэль
шпачанё́|шпачаня́
шпуравы́|шпу́равы
шпі́ндаль|шпі́ндэль
шпі́ндальны|шпі́ндэльны
шротакі́дальны|шротакіда́льны
шрэ́дар|шрэ́дэр
шрэдарава́ць|шрэдэрава́ць
штампава́ны|штампо́ваны
штампавы́|шта́мпавы
шту́цар|шту́цэр
шу́патлівы|шупатлі́вы
шчанё́|шчаня́
шчупако́вы|шчупако́ў
шчы́паны|шчыпа́ны
шчыглянё́|шчыгляня́
шчылі́нны|шчы́лінны
шыро́ка|шы́рака
шэ́рашаўскі|шарашо́ўскі
шэ́рашаўскі|шарашэ́ўскі
шэла́к|шэ́лак
шэсцьдзяся́т|шэ́сцьдзесят
шэсцьдзяся́т|шэсцьдзеся́т
э́дынбургскі|эдынбу́ргскі
экзерсі́с|экзэрсі́с
экзэ́ма|экзе́ма
экзэмпля́р|экземпля́р
экспазэ́|экспазе́
экіпірава́нне|экіпі́раванне
эле́ктрык|электры́к
электраметалу́ргія|электраметалургі́я
электратыпі́я|электраты́пія
электраі́скравы|электраіскравы́
эпенды́ма|эпе́ндыма
эпістрафа́|эпі́страфа
эпіта́ксія|эпітаксі́я
эрзя́|э́рзя
эрлі́фт|э́рліфт
эспа́ндар|эспа́ндэр
эсэ́нцыя|эсе́нцыя
юнка́р|юнко́р
юнка́раўскі|юнко́раўскі
юнка́рка|юнко́рка
юпі́тар|юпі́тэр
я́звеннік|я́звенік
я́звенніца|я́звеніца
ядкі́|я́дкі
яйцавы́|я́йцавы
ястрабянё́|ястрабяня́
ё́гурт|йагу́рт
ё́гуртны|йагу́ртны
ё́ркшырскі|іаркшы́рскі
ё́таваны|ётава́ны
ёркшыр|йаркшы́р
ёркшыр|іаркшы́р
і́|й
і́нець|іне́ць
і́нфікс|інфі́кс
ігры́шча|і́грышча
ізаме́трыя|ізаметры́я
ільвянё́|ільвяня́
імпрэса́рыа|імпрэса́рыо
інвестава́цца|інвесці́равацца
інвестава́ць|інвесці́раваць
інданезі́йскі|інданэзійскі
індычанё́|індычаня́
інса́йдар|інса́йдэр
інтэрпа́л|інтэрпо́л
інтэрпалява́цца|інтэрпалі́равацца
інтэрпалява́ць|інтэрпалі́раваць
інтэрфе́йс|інтэрфэ́йс
іры́савы|і́рысавы
ітэраты́ўны|ітэрацы́йны
іхтыяфа́ўна|іхтыяфа́уна
іўдаі́зм|іудаі́зм
іўдаі́сцкі|іудаі́сцкі
іўдзе́й|іудзе́й
іўдзе́йка|іудзе́йка
іўдзе́йства|іудзе́йства
